NETCODE -> FUNC MASFUNCIONES MAIN | MAIN
MASFUNCIONES -> FUNC MASFUNCIONES | e
FUNC -> FUNCION ID CORCHETEABI PARAMETROS CORCHETECERR OPDATO LLAVEABI INS LLAVECERR
MAIN -> PROGRAMA PRINCIPAL TIPOENTERO CORCHETEABI CORCHETECERR LLAVEABI INS LLAVECERR
OPDATO -> TIPOVACIO | TIPODATO
PARAMETROS -> e | VARIABLE ID TIPODATO MASPARAMETROS
MASPARAMETROS -> COMA PARAMETROS | e
CONDICIONAL -> SI CORCHETEABI EXPRESION CORCHETECERR LLAVEABI INS LLAVECERR POSIBILIDAD
POSIBILIDAD -> SINO CORCHETEABI EXPRESION CORCHETECERR LLAVEABI INS LLAVECERR POSIBILIDAD | ENTONCES LLAVEABI INS LLAVECERR | e
BUCLEWHILE -> MIENTRAS CORCHETEABI EXPRESION CORCHETECERR LLAVEABI INS LLAVECERR
BUCLEFOR -> PARA CORCHETEABI ASIG PUNTOYCOMA EXPRESION PUNTOYCOMA ID DERIVA2 CORCHETECERR LLAVEABI INS LLAVECERR
INS -> INSTRUCCION MASINSTRUCCION | e
DERIVA2 -> UNARIOS | IGUAL EXPRESION
INSTRUCCION -> ASIG | IMP | BUCLEFOR | BUCLEWHILE | CONDICIONAL | DETENER | RETORNAR EXPRESION
MASINSTRUCCION -> INSTRUCCION MASINSTRUCCION | e
IMP -> IMPRIMIR CORCHETEABI CMDS CORCHETECERR
CMDS -> e | EXPRESION MASCOMANDOS
MASCOMANDOS -> CONCATENAR EXPRESION MASCOMANDOS | e
ASIG -> VARIABLE ID TIPODATO OPC | ID OG
OG -> IGUAL EXPRESION | CORCHETEABI PAR CORCHETECERR
OPC -> IGUAL EXPRESION | e
EXPRESION -> CORCHETEABI EXPRESION CORCHETECERR MASEXPRESION | ID OPCION MASEXPRESION | DATO MASEXPRESION
MASEXPRESION -> e | OPERACION EXPRESION
OPCION -> CORCHETEABI PAR CORCHETECERR | e
PAR -> TF RESTO_PARAMETROS | e
RESTO_PARAMETROS -> COMA TF RESTO_PARAMETROS | e
TF -> DATO MASEXPRESION | ID OPCION MASEXPRESION
OPERACION -> SUMA | RESTA | MULTIPLICACION | DIVISION | RESIDUO | IGUALBOOLEANO | MENORQUE | MAYORQUE | MENORIGUALQUE | MAYORIGUALQUE | DIFERENTEDE | Y | O
DATO -> NCADENA | NDECIMAL | NENTERO | NBOOLEANO
TIPODATO -> TIPOENTERO | TIPOCADENA | TIPODECIMAL | TIPOBOOLEANO
UNARIOS -> AUMENTAR | DISMINUIR